#######..#######
#..............#
#..............#
#..............#
#..............#
#..............#
#..............#
...............#
...............#
#..............#
#..............#
#..............#
#..............#
#..............#
#..............#
################