################
#..............#
#..............#
#..............#
#..............#
#..............#
#..............#
#...............
#...............
#..............#
#..............#
#..............#
#..............#
#..............#
#..............#
################