#######..#######
#..............#
#..............#
#..............#
#..............#
#..............#
#..............#
#...............
#...............
#..............#
#..............#
#..............#
#..............#
#..............#
#..............#
#######..#######